11111
10001
11101
1CEP1
11111
