111111111111111111111111111
100000000000010000000000001
1C11110111110101111101111C1
101G010100G10101G001010G101
101111011111010111110111101
100000000000000000000000001
101111010111111111010111101
100000010000010000010000001
111111011111010111110111111
1000G10100000G00000101G0001
111111010111111111010111111
1E00000001G00000G10000000G1
111111010111111111010111111
1G00010100000000000101000G1
111111011111010111110111111
100000000000010000000000001
101111011111010111110111101
1C00010000000P00000001000C1
111101010111111111010101111
100000010000010000010000001
101111111111010111111111101
10G00000000000000000G000001
111111111111111111111111111
