111111111111111111111111111
10000000000001G000000000001
1C11110111110101111101111C1
101001010001010100010100101
101111011111010111110111101
100000000000000000000000001
101111010111111111010111101
100000010000010000010000001
111111011111010111110111111
1000010100000G0000010100001
111111010111111111010111111
1E0000000100000001000000001
111111010111111111010111111
100001010000000000010100001
111111011111010111110111111
100000000000010000000000001
101111011111010111110111101
1C00G10000000P00000001000C1
111101010111111111010101111
100000010000010000010000001
101111111111010111111111101
10G00000000000000000G000001
111111111111111111111111111
