111111111
100CE0001
100000001
111111111
