111111111
100CE0001
1P0000P01
111111111
