111111111
100C00001
10E000P01
011111111
