111111110
100C00001
10E000P01
111111111
