111111111
100C00000
10E000P01
111111111
