111111111
100C00001
00E000P01
111111111
