111111111
100C00001
1EG000P01
111111111
