111111111
100000E01
100000P01
111111111
