111111111
100C00001
100000P01
111111111
