111111111
100CE0001
1000000P01
111111111
