111111111
100CE0001
100000P01
111111111
1111
