111111111
100CE01
100000P01
111111111
