111111
1CEP01
100001
111011
100001
111111
