111111111
100C00E01
1E0000P01
111111111
